8;8; Rows/Columns
S0100010
00110M0M
01100600
0010MM00
001M1100
0MMM0100
0MM00001
0M01110A