8;8; Rows/Columns
10010010
0MM0MMA1
AMM0MMM0
0MM0MMM0
1MM00001
0MMMMMM0
0MMMMMM0
S001A001