10;10;
S30MMM000A
610MM00M00
01MMMMM050
0111111100
000001MM01
0M00010MMM
MMM0010MMM
0M0M01MMMM
0MMM000000
A00MM0000A